NO ./textures/beds.png
WE ./textures/campus.png
SO ./textures/cluster.png
EA ./textures/lobby.png

F 171,181,187
C 50,50,52

                     11111111111
                     10000000001
                     1000000000
         1111111111  10000000001
         1000000001  10000000001
         1000000001  10000000001
         100000000111100000000011111111111111
         100000000000000000000000000000000001
         111100000011111111110000111111000001
         111100000011      110000111111000001111
         100000000001      100000000000000000001
         100000000001      100000000000000000001
         100000000001      100000111100000000001
         100000000001      100000001100000000001
         100000000001      100000001100000000001
         100000000001      100000001100000000001
         100000000001      100000001100000000001
1111111  100000000001      100000001100000000001
1000001  100000000001      100000001100000000001
1000001  100000000001      100000001100000000001
1111101  100000000001      100000001100000000001
100000111100000000001      100000001100000000001
100000000000000000001      100000001100000000001
100000000000000000001      100000001100000000001
111111111100000000001      100000001100000000001
         100000000001      100000001100000000001
         100000000001      100000001100000000001
         100000000001      100000001100000000001
         100000000001      100000001100000000001
         100000000111      100000001100000000001
         100000000111111111100000011100000000001
         100000000000000000000000000000000111111
         1000000000000000000000000000000001
         1000000000000000000000000000000001
         1000000000000000000000000000000001
         1000000000000000000000000000000001
         1111111111000001111111111111111111
                  1000001
                  1000001
                  1000001
                  1000001
                  1000001
                  100N001
                  1111111

