NO ./textures/minecraft.png
WE ./textures/psico.png
SO ./textures/one_piece.png
EA ./textures/efect.png

F 161,87,18
C 5,238,246

    11111111111
  11100000000011
 1100000111000011
 1000001111111001
110000100111111011
100001100110011001
100011100110011001
10001 111111111011N
1000111111111110011
100001100110011001
110001110100111001
 10001110001110011
 1100011111110001
  100001111100011
  11100000000111
    1111000111
       11111