NO ./textures/minecraft.png
WE ./textures/one_piece.png
SO ./textures/efect.png
EA ./textures/psico.png

F 171,181,187
C 50,50,52

11111111111111111111
100N00000000000000001
111111111111111111111
