NO ./textures/beds.png
WE ./textures/campus.png
SO ./textures/cluster.png
EA ./textures/lobby.png

F 171,181,187
C 50,50,52

111111111111111111111
100N00000000000000001
111111111111111111111
