SO ./textures/beds.png
WE ./textures/blue.png
EA ./textures/tree.png
NO ./textures/grey.png

C 9, 24, 51
F 48, 27, 104

111111111111
100000000001
100010011101
100000000101
101110001101
100000000001
111111111111
11111
11111
10S01
11111