NO ./textures/minecraft.png
WE ./textures/psico.png
SO ./textures/one_piece.png
EA ./textures/efect.png

F 171,181,187
C 50,50,52

11111
10S01
11111
