NO ./textures/beds.png
WE ./textures/campus.png
SO ./textures/cluster.png
EA ./textures/lobby.png

F 161,87,18
C 5,238,246

11111111111
10000000001
10000110001
10000110001
1000N110001
10000110001
10000000001
11111111111
