NO 
WE ./textures/psico.png
SO ./textures/one_piece.png
EA ./textures/efect.png

NOL                                    ./textures/minecraft.png
WE ./textures/psico.png
SO ./textures/one_piece.png
EA ./textures/run.png
F 171,181,187
C 0,0,0000000000000000000000000000000000000000000000000000000000000000000000000000000000000000000

11111
100N1                                       1   
1111
   111




