NO ./textures/minecraft.png
WE ./textures/psico.png
SO ./textures/one_piece.png
EA ./textures/efect.png

F 171,181,187
C 50,50,52

1111111
100S001
1000001
1000011
1111110
1111111
